NO ./textures/BRICK_3D.xpm
WE ./textures/FLOOR_1B.xpm
SO ./textures/STUCCO_1D.xpm
EA ./textures/TECH_5A.xpm
F 128,180,30
C 90,150, 200 

        1111111111111111111111111
        1000000000110000000000001
        1011000001110000000000001
        1001000000000000000000001
111111111011000001110000000000001
10000000001100000111011111D111111
11110111111111011100000010001
11110111111111011101010010001
11000000110101011100000010001
1000000000000000D0000000D0001
10000000000000001101010010001
11000001110101011111011110N0111
11110111 1110101 101111010001
11111111 1111111 111111111111
